사랑 - любовь
학교 - школа
음식 - еда
친구 - друг
가족 - семья
집 - дом
물 - вода
커피 - кофе
차 - чай
책 - книга
공부 - учеба
선생님 - учитель
학생 - студент
회사 - компания
일 - работа
시간 - время
날씨 - погода
하늘 - небо
바다 - море
산 - гора
강 - река
도시 - город
길 - дорога
집안일 - домашние дела
음악 - музыка
영화 - фильм
노래 - песня
춤 - танец
운동 - спорт
축구 - футбол
농구 - баскетбол
야구 - бейсбол
수영 - плавание
달리기 - бег
자전거 - велосипед
자동차 - машина
버스 - автобус
지하철 - метро
기차 - поезд
비행기 - самолет
공항 - аэропорт
여행 - путешествие
호텔 - отель
식당 - ресторан
카페 - кафе
시장 - рынок
상점 - магазин
가격 - цена
할인 - скидка
돈 - деньги
은행 - банк
의사 - врач
병원 - больница
약 - лекарство
건강 - здоровье
몸 - тело
손 - рука
발 - нога
머리 - голова
눈 - глаз
귀 - ухо
코 - нос
입 - рот
음료수 - напиток
과일 - фрукт
채소 - овощ
고기 - мясо
생선 - рыба
빵 - хлеб
밥 - рис
국 - суп
김치 - кимчи
소금 - соль
설탕 - сахар
우유 - молоко
치즈 - сыр
계란 - яйцо
과자 - сладости
옷 - одежда
신발 - обувь
모자 - шапка
가방 - сумка
시계 - часы
휴대폰 - мобильный телефон
컴퓨터 - компьютер
인터넷 - интернет
전화 - телефон
편지 - письмо
사진 - фотография
영수증 - чек
열쇠 - ключ
문 - дверь
창문 - окно
의자 - стул
책상 - стол
침대 - кровать
소파 - диван
라디오 - радио
텔레비전 - телевизор
영화관 - кинотеатр
음식점 - ресторан
카페트 - ковёр
장난감 - игрушка

